003020600
900305001
001806400
008102900
700000008
006708200
002609500
80020